111111111111111111111
110E0000000CC000C0X01
100001010010000010101
1000010010101010X0101
111P000X00C000XC00001
111111111111111111111